CREATE TABLE data
(subjectcode	text,
dataset	text,
subjectvisitid	text,
subjectvisitdate	text,
av45	real,
fdg	real,
pib	real,
brainstem	real,
tiv	real,
_3rdventricle	real,
_4thventricle	real,
csfglobal	real,
leftinflatvent	real,
leftlateralventricle	real,
rightinflatvent	real,
rightlateralventricle	real,
cerebellarvermallobulesiv	real,
cerebellarvermallobulesviiix	real,
cerebellarvermallobulesvivii	real,
leftcerebellumexterior	real,
rightcerebellumexterior	real,
leftamygdala	real,
rightamygdala	real,
leftaccumbensarea	real,
leftbasalforebrain	real,
leftcaudate	real,
leftpallidum	real,
leftputamen	real,
rightaccumbensarea	real,
rightbasalforebrain	real,
rightcaudate	real,
rightpallidum	real,
rightputamen	real,
leftventraldc	real,
rightventraldc	real,
leftaorganteriororbitalgyrus	real,
leftcocentraloperculum	real,
leftfofrontaloperculum	real,
leftfrpfrontalpole	real,
leftgregyrusrectus	real,
leftlorglateralorbitalgyrus	real,
leftmfcmedialfrontalcortex	real,
leftmfgmiddlefrontalgyrus	real,
leftmorgmedialorbitalgyrus	real,
leftmprgprecentralgyrusmedialsegment	real,
leftmsfgsuperiorfrontalgyrusmedialsegment	real,
leftopifgopercularpartoftheinferiorfrontalgyrus	real,
leftorifgorbitalpartoftheinferiorfrontalgyrus	real,
leftpoparietaloperculum	real,
leftporgposteriororbitalgyrus	real,
leftprgprecentralgyrus	real,
leftscasubcallosalarea	real,
leftsfgsuperiorfrontalgyrus	real,
leftsmcsupplementarymotorcortex	real,
lefttrifgtriangularpartoftheinferiorfrontalgyrus	real,
rightaorganteriororbitalgyrus	real,
rightcocentraloperculum	real,
rightfofrontaloperculum	real,
rightfrpfrontalpole	real,
rightgregyrusrectus	real,
rightlorglateralorbitalgyrus	real,
rightmfcmedialfrontalcortex	real,
rightmfgmiddlefrontalgyrus	real,
rightmorgmedialorbitalgyrus	real,
rightmprgprecentralgyrusmedialsegment	real,
rightmsfgsuperiorfrontalgyrusmedialsegment	real,
rightopifgopercularpartoftheinferiorfrontalgyrus	real,
rightorifgorbitalpartoftheinferiorfrontalgyrus	real,
rightpoparietaloperculum	real,
rightporgposteriororbitalgyrus	real,
rightprgprecentralgyrus	real,
rightscasubcallosalarea	real,
rightsfgsuperiorfrontalgyrus	real,
rightsmcsupplementarymotorcortex	real,
righttrifgtriangularpartoftheinferiorfrontalgyrus	real,
leftainsanteriorinsula	real,
leftpinsposteriorinsula	real,
rightainsanteriorinsula	real,
rightpinsposteriorinsula	real,
leftacgganteriorcingulategyrus	real,
leftententorhinalarea	real,
lefthippocampus	real,
leftmcggmiddlecingulategyrus	real,
leftpcggposteriorcingulategyrus	real,
leftphgparahippocampalgyrus	real,
leftthalamusproper	real,
rightacgganteriorcingulategyrus	real,
rightententorhinalarea	real,
righthippocampus	real,
rightmcggmiddlecingulategyrus	real,
rightpcggposteriorcingulategyrus	real,
rightphgparahippocampalgyrus	real,
rightthalamusproper	real,
leftcalccalcarinecortex	real,
leftcuncuneus	real,
leftioginferioroccipitalgyrus	real,
leftliglingualgyrus	real,
leftmogmiddleoccipitalgyrus	real,
leftocpoccipitalpole	real,
leftofugoccipitalfusiformgyrus	real,
leftsogsuperioroccipitalgyrus	real,
rightcalccalcarinecortex	real,
rightcuncuneus	real,
rightioginferioroccipitalgyrus	real,
rightliglingualgyrus	real,
rightmogmiddleoccipitalgyrus	real,
rightocpoccipitalpole	real,
rightofugoccipitalfusiformgyrus	real,
rightsogsuperioroccipitalgyrus	real,
leftangangulargyrus	real,
leftmpogpostcentralgyrusmedialsegment	real,
leftpcuprecuneus	real,
leftpogpostcentralgyrus	real,
leftsmgsupramarginalgyrus	real,
leftsplsuperiorparietallobule	real,
rightangangulargyrus	real,
rightmpogpostcentralgyrusmedialsegment	real,
rightpcuprecuneus	real,
rightpogpostcentralgyrus	real,
rightsmgsupramarginalgyrus	real,
rightsplsuperiorparietallobule	real,
leftfugfusiformgyrus	real,
leftitginferiortemporalgyrus	real,
leftmtgmiddletemporalgyrus	real,
leftppplanumpolare	real,
leftptplanumtemporale	real,
leftstgsuperiortemporalgyrus	real,
lefttmptemporalpole	real,
leftttgtransversetemporalgyrus	real,
rightfugfusiformgyrus	real,
rightitginferiortemporalgyrus	real,
rightmtgmiddletemporalgyrus	real,
rightppplanumpolare	real,
rightptplanumtemporale	real,
rightstgsuperiortemporalgyrus	real,
righttmptemporalpole	real,
rightttgtransversetemporalgyrus	real,
leftcerebellumwhitematter	real,
leftcerebralwhitematter	real,
opticchiasm	real,
rightcerebellumwhitematter	real,
rightcerebralwhitematter	real,
alzheimerbroadcategory	text,
neurodegenerativescategories	text,
parkinsonbroadcategory	text,
adnicategory	text,
edsdcategory	text,
ppmicategory	text,
DIAG_etiology_1	text,
DIAG_etiology_2	text,
DIAG_etiology_3	text,
DIAG_lng	text,
DIAG_lngapp	text,
DIAG_stade	text,
DIAG_stademin	text,
DIAG_syndamn	text,
DIAG_syndoth	text,
DIAG_syndr	text,
minimentalstate	int,
montrealcognitiveassessment	int,
updrshy	text,
updrstotal	int,
agegroup	text,
gender	text,
handedness	text,
subjectage	real,
subjectageyears	int,
apoe4	text,
rs10498633_t	text,
rs11136000_t	text,
rs11767557_c	text,
rs1476679_c	text,
rs17125944_c	text,
rs190982_g	text,
rs2718058_g	text,
rs3764650_g	text,
rs3818361_t	text,
rs3851179_a	text,
rs3865444_t	text,
rs610932_a	text,
rs744373_c	text,
ab1_42	real,
ab1_40	real,
t_tau	real,
p_tau	real);